maze.cpp运行结果:
迷宫问题求解:

返回迷宫开始位置.
# # 0 # # # # # # # 
# 0 # # 0 0 0 # # # 
# 0 0 0 # # # x x # 
# 0 0 # # # x # x # 
# # # x # x x # x x 
# # # x x x x x x # 
# # # x # x x x # # 
# # # # # # # # # # 

